Map:

_, _, 2, 1, 1
2, 2, 4, _, _
_, _, 4, _, 2
1, 2, _, 3, 2
0, _, 1, 2, _

Solution:

G, T, 2, 1, 1
2, 2, 4, T, G
G, T, 4, T, 2
1, 2, T, 3, 2
0, G, 1, 2, T
