Map:

_, 1, 1, 2, 1, _, _, 2, _
0, 1, _, 3, _, 2, 1, _, _
1, 2, 3, _, _, 4, 2, _, 2
2, _, 3, _, _, _, 3, 1, 1
_, _, 4, _, 8, _, 4, 1, 1
1, 1, 2, _, _, _, _, _, 2
2, 3, 3, 4, 4, 3, 4, _, 3
_, _, _, _, _, 1, 3, _, 3
2, 3, 2, 2, 1, 1, 2, _, 2

Solution:

G, 1, 1, 2, 1, G, G, 2, T
0, 1, T, 3, T, 2, 1, G, T
1, 2, 3, G, T, 4, 2, T, 2
2, T, 3, T, T, T, 3, 1, 1
T, G, 4, T, 8, T, 4, 1, 1
1, 1, 2, T, T, T, G, T, 2
2, 3, 3, 4, 4, 3, 4, T, 3
T, T, T, G, T, 1, 3, T, 3
2, 3, 2, 2, 1, 1, 2, T, 2

